"filename", "language", "C++", "comment", "blank", "total"
"/home/matt/Documents/PA/ProjetPA/lib/Cartes/cartes.cpp", "C++", 119, 1, 38, 158
"/home/matt/Documents/PA/ProjetPA/lib/Cartes/cartes.hpp", "C++", 62, 0, 7, 69
"/home/matt/Documents/PA/ProjetPA/lib/Cartes/tile.cpp", "C++", 18, 0, 8, 26
"/home/matt/Documents/PA/ProjetPA/lib/Cartes/tile.hpp", "C++", 16, 0, 6, 22
"/home/matt/Documents/PA/ProjetPA/lib/HUD/hud.cpp", "C++", 35, 0, 5, 40
"/home/matt/Documents/PA/ProjetPA/lib/HUD/hud.hpp", "C++", 21, 0, 3, 24
"/home/matt/Documents/PA/ProjetPA/lib/Variables/variables.cpp", "C++", 7, 0, 3, 10
"/home/matt/Documents/PA/ProjetPA/lib/Variables/variables.hpp", "C++", 23, 0, 7, 30
"/home/matt/Documents/PA/ProjetPA/lib/button/button.cpp", "C++", 76, 1, 18, 95
"/home/matt/Documents/PA/ProjetPA/lib/button/button.hpp", "C++", 25, 1, 7, 33
"/home/matt/Documents/PA/ProjetPA/lib/display/display.cpp", "C++", 31, 1, 10, 42
"/home/matt/Documents/PA/ProjetPA/lib/display/display.hpp", "C++", 16, 0, 6, 22
"/home/matt/Documents/PA/ProjetPA/lib/donjon/donjon.cpp", "C++", 401, 5, 69, 475
"/home/matt/Documents/PA/ProjetPA/lib/donjon/donjon.hpp", "C++", 60, 5, 14, 79
"/home/matt/Documents/PA/ProjetPA/lib/donjon/tree.cpp", "C++", 124, 1, 35, 160
"/home/matt/Documents/PA/ProjetPA/lib/donjon/tree.hpp", "C++", 66, 6, 13, 85
"/home/matt/Documents/PA/ProjetPA/lib/gamemode/gamemode.cpp", "C++", 13, 2, 1, 16
"/home/matt/Documents/PA/ProjetPA/lib/gamemode/gamemode.hpp", "C++", 23, 0, 6, 29
"/home/matt/Documents/PA/ProjetPA/lib/jeu/jeu.cpp", "C++", 101, 3, 18, 122
"/home/matt/Documents/PA/ProjetPA/lib/jeu/jeu.hpp", "C++", 18, 0, 3, 21
"/home/matt/Documents/PA/ProjetPA/lib/maps/assets.cpp", "C++", 34, 0, 9, 43
"/home/matt/Documents/PA/ProjetPA/lib/maps/assets.hpp", "C++", 14, 0, 2, 16
"/home/matt/Documents/PA/ProjetPA/lib/maps/maps.cpp", "C++", 161, 49, 43, 253
"/home/matt/Documents/PA/ProjetPA/lib/maps/maps.hpp", "C++", 45, 8, 8, 61
"/home/matt/Documents/PA/ProjetPA/lib/menu/menu.cpp", "C++", 55, 6, 12, 73
"/home/matt/Documents/PA/ProjetPA/lib/menu/menu.hpp", "C++", 25, 0, 5, 30
"/home/matt/Documents/PA/ProjetPA/lib/pause/pauses.cpp", "C++", 59, 7, 13, 79
"/home/matt/Documents/PA/ProjetPA/lib/pause/pauses.hpp", "C++", 24, 0, 4, 28
"/home/matt/Documents/PA/ProjetPA/lib/player/player.cpp", "C++", 211, 3, 54, 268
"/home/matt/Documents/PA/ProjetPA/lib/player/player.hpp", "C++", 75, 9, 19, 103
"/home/matt/Documents/PA/ProjetPA/lib/sprites/sprite.cpp", "C++", 167, 2, 28, 197
"/home/matt/Documents/PA/ProjetPA/lib/sprites/sprite.hpp", "C++", 39, 28, 8, 75
"/home/matt/Documents/PA/ProjetPA/lib/utility/utility.cpp", "C++", 73, 0, 10, 83
"/home/matt/Documents/PA/ProjetPA/lib/utility/utility.hpp", "C++", 18, 0, 9, 27
"/home/matt/Documents/PA/ProjetPA/lib/weapon/armes.cpp", "C++", 79, 0, 17, 96
"/home/matt/Documents/PA/ProjetPA/lib/weapon/armes.hpp", "C++", 42, 0, 6, 48
"/home/matt/Documents/PA/ProjetPA/lib/world/world.cpp", "C++", 125, 8, 32, 165
"/home/matt/Documents/PA/ProjetPA/lib/world/world.hpp", "C++", 40, 3, 9, 52
"Total", "-", 2541, 149, 565, 3255